000000000000000
000000000000000
000000000000000
000000000000000
000000000000000
000000000000000
000000000000000
000000000000000
000000000000000
000000000000000
000000000000000
000000000000000
000000000000000
000000000000000
000000000000000
000000000000000
000000000000000
000000000000000

000001100000000
000001100000000
000001100000000
000001100000110
000000000001100
111100000011000
111100000110000
000000001100000
000000011000000
000000110000000
000001100000000
000011000001111
000110000001111
001100000000000
011000001100000
000000001100000
000000001100000
000000001100000

000000000000000
000011101110000
000011101110000
011000000000110
011000000000110
011000111000110
011000111000110
000000111000000
000111111111000
000111111111000
000000111000000
011000111000110
011000111000110
011000000000110
011000000000110
000011101110000
000011101110000
000000000000000

000000000000000
000000000000000
000000000000000
000111000111000
001111101111100
001111101111100
001111101111100
000111000111000
000000000000000
000000000000000
000111000111000
001111101111100
001111101111100
001111101111100
000111000111000
000000000000000
000000000000000
000000000000000

000000000000000
001100000001100
011110000011110
011110000011110
001100000001100
000000000000000
000000111000000
000001111100000
000011111110000
000011111110000
000001111100000
000000111000000
000000000000000
001100000001100
011110000011110
011110000011110
001100000001100
000000000000000

000000000000000
000001111100000
000001111100000
000001111100000
000001111100000
000000000000000
000000000000000
011111000111110
011111000111110
011111000111110
011111000111110
000000000000000
000000000000000
000001111100000
000001111100000
000001111100000
000001111100000
000000000000000

000000000000000
000000000000000
000000000000000
001111000111100
001111000111100
001111000111100
001111000111100
000000000000000
000000000000000
000000000000000
000000000000000
001111000111100
001111000111100
001111000111100
001111000111100
000000000000000
000000000000000
000000000000000

000000000000000
000000000000000
111111111110000
111111111110000
000000000000000
000000000000000
000011111111111
000011111111111
000000000000000
000000000000000
111111111110000
111111111110000
000000000000000
000000000000000
000011111111111
000011111111111
000000000000000
000000000000000

000011100011000
000011100011000
000011100011000
000011100011000
000011100011000
000011100011000
000000100001000
000000100001000
000100101001000
000100101001000
000100001000000
000100001000000
000110001110000
000110001110000
000110001110000
000110001110000
000110001110000
000110001110000

000000000000000
000000000000000
000001110000000
000001110000000
000001110000000
111111110000000
111111110000000
000000000000000
000000000000000
000000000000000
000000000000000
000000011111111
000000011111111
000000011100000
000000011100000
000000011100000
000000000000000
000000000000000

000000000000000
000000000000000
011000000000110
011100000001110
011110000011110
001111000111100
000111101111000
000011111110000
000001111100000
000001111100000
000011111110000
000111101111000
001111000111100
011110000011110
011100000001110
011000000000110
000000000000000
000000000000000

000000000000000
000000000000000
000000000000000
000000000000000
000001111100000
000001111100000
000001111100000
001111111111100
001111111111100
001111111111100
001111111111100
000001111100000
000001111100000
000001111100000
000000000000000
000000000000000
000000000000000
000000000000000

000111111111000
000011111110000
000001111100000
000000111000000
100000010000001
110000000000011
111000000000111
111100000001111
111110000011111
111110000011111
111100000001111
111000000000111
110000000000011
100000010000001
000000111000000
000001111100000
000011111110000
000111111111000

000000000000000
000000000000000
001111000111100
001111000111100
000011000110000
000011000110000
000011000110000
000011000110000
000011000110000
000011000110000
000011000110000
000011000110000
000011000110000
000011000110000
001111000111100
001111000111100
000000000000000
000000000000000

000001100000000
000001100000000
000001100000000
000001100000000
000001100000000
001111100000000
001111100000000
000000000000000
000000000000000
000000000000000
000000000000000
000000001111100
000000001111100
000000001100000
000000001100000
000000001100000
000000001100000
000000001100000

000000111000000
000000111000000
000000111000000
000000111000000
000000111000000
000000111000000
000000111000000
000000000000000
000000000000000
000000000000000
000000000000000
000000111000000
000000111000000
000000111000000
000000111000000
000000111000000
000000111000000
000000111000000

000000000000000
000000000000000
000000000000000
000000000000000
000000000000000
000000000000000
111111000111111
111111000111111
111111000111111
111111000111111
111111000111111
111111000111111
000000000000000
000000000000000
000000000000000
000000000000000
000000000000000
000000000000000

000000000000000
000000000000000
000001101100000
000001101100000
000001101100000
000001101100000
001111101111100
001111101111100
000000000000000
000000000000000
001111101111100
001111101111100
000001101100000
000001101100000
000001101100000
000001101100000
000000000000000
000000000000000
